21 00 00 00 00 00 00 00 00 00 00 00 00 00 00 00 00 00 00 00 00 00 00 00 00 00 00 00 00 00 00 00 22 00 00 00 00 00 00 00 00 00 00 00 00 00 00 00 00 00 00 00 00 00 00 00 00 00 00 00 00 00 00 00 23 00 00 00 00 00 00 00 00 00 00 00 00 00 00 00 00 00 00 00 00 00 00 00 00 00 00 00 00 00 00 00 24 00 00 00 00 00 00 00 00 00 00 00 00 00 00 00 00 00 00 00 00 00 00 00 00 00 00 00 00 00 00 00 25 00 00 00 00 00 00 00 00 00 00 00 00 00 00 00 00 00 00 00 00 00 00 00 00 00 00 00 00 00 00 00
00 00 00 00 00 00 00 00 00 00 00 00 00 00 00 00 00 00 00 00 00 00 00 00 00 00 00 00 00 00 00 00 00 00 00 00 00 00 00 00 00 00 00 00 00 00 00 00 00 00 00 00 00 00 00 00 00 00 00 00 00 00 00 00 00 00 00 00 00 00 00 00 00 00 00 00 00 00 00 00 00 00 00 00 00 00 00 00 00 00 00 00 00 00 00 00 00 00 00 00 00 00 00 00 00 00 00 00 00 00 00 00 00 00 00 00 00 00 00 00 00 00 00 00 00 00 00 00 00 00 00 00 00 00 00 00 00 00 00 00 00 00 00 00 00 00 00 00 00 00 00 00 00 00 00 00 00 00 00 00
00 00 00 00 00 00 00 00 00 00 00 00 00 00 00 00 00 00 00 00 00 00 00 00 00 00 00 00 00 00 00 00 00 00 00 00 00 00 00 00 00 00 00 00 00 00 00 00 00 00 00 00 00 00 00 00 00 00 00 00 00 00 00 00 00 00 00 00 00 00 00 00 00 00 00 00 00 00 00 00 00 00 00 00 00 00 00 00 00 00 00 00 00 00 00 00 00 00 00 00 00 00 00 00 00 00 00 00 00 00 00 00 00 00 00 00 00 00 00 00 00 00 00 00 00 00 00 00 00 00 00 00 00 00 00 00 00 00 00 00 00 00 00 00 00 00 00 00 00 00 00 00 00 00 00 00 00 00 00 00
00 00 00 00 00 00 00 00 00 00 00 00 00 00 00 00 00 00 00 00 00 00 00 00 00 00 00 00 00 00 00 00 00 00 00 00 00 00 00 00 00 00 00 00 00 00 00 00 00 00 00 00 00 00 00 00 00 00 00 00 00 00 00 00 00 00 00 00 00 00 00 00 00 00 00 00 00 00 00 00 00 00 00 00 00 00 00 00 00 00 00 00 00 00 00 00 00 00 00 00 00 00 00 00 00 00 00 00 00 00 00 00 00 00 00 00 00 00 00 00 00 00 00 00 00 00 00 00 00 00 00 00 00 00 00 00 00 00 00 00 00 00 00 00 00 00 00 00 00 00 00 00 00 00 00 00 00 00 00 00
00 00 00 00 00 00 00 00 00 00 00 00 00 00 00 00 00 00 00 00 00 00 00 00 00 00 00 00 00 00 00 00 00 00 00 00 00 00 00 00 00 00 00 00 00 00 00 00 00 00 00 00 00 00 00 00 00 00 00 00 00 00 00 00 00 00 00 00 00 00 00 00 00 00 00 00 00 00 00 00 00 00 00 00 00 00 00 00 00 00 00 00 00 00 00 00 00 00 00 00 00 00 00 00 00 00 00 00 00 00 00 00 00 00 00 00 00 00 00 00 00 00 00 00 00 00 00 00 00 00 00 00 00 00 00 00 00 00 00 00 00 00 00 00 00 00 00 00 00 00 26 27 27 27 28 00 00 00 00 00
00 00 00 00 00 00 00 00 00 00 00 00 00 00 00 00 00 00 00 00 00 00 00 00 00 00 00 00 00 00 00 00 00 00 00 00 00 00 26 27 27 27 27 27 28 00 00 26 27 27 27 27 27 28 00 00 00 00 00 00 00 00 00 00 00 00 00 00 00 00 00 00 00 00 00 00 00 00 00 00 00 00 00 00 00 00 00 00 00 00 00 00 00 00 00 00 00 00 00 00 00 00 00 00 00 00 00 00 00 00 00 26 27 27 27 28 00 00 00 26 27 27 27 28 00 00 00 00 00 00 00 00 00 00 00 00 00 26 27 27 27 27 27 28 00 00 00 00 00 00 29 34 30 34 31 00 00 00 00 00
00 00 00 00 00 00 00 00 00 00 00 00 00 00 00 00 00 00 00 00 00 26 27 27 27 28 00 00 00 00 00 00 00 00 00 00 00 00 29 32 30 32 30 32 31 00 00 29 33 33 33 33 33 27 27 27 27 28 00 00 00 00 00 00 00 00 00 00 00 00 00 26 27 27 28 00 00 00 00 00 00 00 00 00 00 00 00 00 00 00 00 00 00 00 26 27 27 28 00 00 00 00 00 00 00 00 00 00 00 00 00 29 33 33 33 31 00 00 00 29 34 30 34 31 00 00 00 00 00 00 00 00 00 00 00 00 00 29 34 30 34 30 34 31 00 00 00 00 00 00 29 34 30 34 31 00 00 00 00 00
00 26 27 27 27 27 27 28 00 26 27 27 27 27 27 27 27 27 27 28 00 29 32 30 32 31 00 00 00 00 00 00 26 27 27 27 27 27 27 32 30 32 30 32 31 00 00 29 33 33 33 33 33 33 33 33 33 31 00 00 00 00 26 27 27 27 27 27 28 00 00 29 33 33 31 00 00 00 00 00 00 00 00 00 00 00 00 26 27 27 27 28 00 00 29 33 33 27 27 27 27 27 27 27 27 27 27 27 27 27 27 27 33 33 33 31 00 00 00 29 34 30 34 31 00 00 00 00 00 00 00 00 00 00 00 00 00 29 34 30 34 30 34 31 00 00 26 27 27 27 27 34 30 34 31 00 00 26 27 27
00 29 32 30 32 30 32 31 00 29 32 30 32 30 32 30 32 30 32 31 00 29 32 30 32 27 27 27 27 27 27 27 27 32 30 32 30 32 30 32 30 32 30 32 31 00 00 29 33 33 33 33 33 33 33 33 33 31 00 00 00 00 29 33 33 33 33 33 31 00 00 29 33 33 27 27 27 27 27 27 27 27 27 27 27 27 27 27 33 33 33 31 00 00 29 33 33 33 33 33 33 33 33 33 33 33 33 33 33 33 33 33 33 33 33 31 00 00 00 29 34 30 34 27 27 27 27 27 27 27 27 27 27 27 27 27 27 27 34 30 34 30 34 31 00 00 29 34 30 34 30 34 30 34 31 00 00 29 34 30