01 00 00 00 00 00 00 00 00 00 00 00 00 00 00 00 00 00 00 00 00 00 00 00 00 00 00 00 00 00 00 00 02 00 00 00 00 00 00 00 00 00 00 00 00 00 00 00 00 00 00 00 00 00 00 00 00 00 00 00 00 00 00 00 03 00 00 00 00 00 00 00 00 00 00 00 00 00 00 00 00 00 00 00 00 00 00 00 00 00 00 00 00 00 00 00 04 00 00 00 00 00 00 00 00 00 00 00 00 00 00 00 00 00 00 00 00 00 00 00 00 00 00 00 00 00 00 00 05 00 00 00 00 00 00 00 00 00 00 00 00 00 00 00 00 00 00 00 00 00 00 00 00 00 00 00 00 00 00 00
00 00 00 00 00 00 00 00 00 00 00 00 00 00 00 00 00 00 00 00 00 00 00 00 00 00 00 00 00 00 00 00 00 00 00 00 00 00 00 00 00 00 00 00 00 00 00 00 00 00 00 00 00 00 00 00 00 00 00 00 00 00 00 00 00 00 00 00 00 00 00 00 00 00 00 00 00 00 00 00 00 00 00 00 00 00 00 00 00 00 00 00 00 00 00 00 00 00 00 00 00 00 00 00 00 00 00 00 00 00 00 00 00 00 00 00 00 00 00 00 00 00 00 00 00 00 00 00 00 00 00 00 00 00 00 00 00 00 00 00 00 00 00 00 00 00 00 00 00 00 00 00 00 00 00 00 00 00 00 00
00 00 00 00 00 00 00 00 00 00 00 00 00 00 00 00 00 00 00 00 00 00 00 00 00 00 00 00 00 00 00 00 00 00 00 00 00 00 00 00 00 00 00 00 00 00 00 00 00 00 00 00 00 00 00 00 00 00 00 00 00 00 00 00 00 00 00 00 00 00 00 00 00 00 00 00 00 00 00 00 00 00 00 00 00 00 00 00 00 00 00 00 00 00 00 00 00 00 00 00 00 00 00 00 00 00 00 00 00 00 00 00 00 00 00 00 00 00 00 00 00 00 00 00 00 00 00 00 00 00 00 00 00 00 00 00 00 00 00 00 00 00 00 00 00 00 00 00 00 00 00 00 00 00 00 00 00 00 00 00
00 00 00 00 00 00 00 00 00 00 00 00 00 00 00 00 00 00 00 00 00 00 00 00 00 00 00 00 00 00 00 00 00 00 00 00 00 00 00 00 00 00 00 00 00 00 00 00 00 00 00 00 00 00 00 00 00 00 00 00 00 00 00 00 00 00 00 00 00 00 00 00 00 00 00 00 00 00 00 00 00 00 00 00 00 00 00 00 00 00 00 00 00 00 00 00 00 00 00 00 00 00 00 00 00 00 00 00 00 00 00 00 00 00 00 00 00 00 00 00 00 00 00 00 00 00 00 00 00 00 00 00 00 00 00 00 00 00 00 00 00 00 00 00 00 00 00 00 00 00 00 00 00 00 00 00 00 00 00 00
00 00 00 00 00 00 00 00 00 00 00 00 00 00 00 00 00 00 00 00 00 00 00 00 00 00 00 00 00 00 00 00 00 00 00 00 00 00 00 00 00 00 00 00 00 00 00 00 00 00 00 00 00 00 00 00 00 00 00 00 00 00 00 00 00 00 00 00 00 00 00 00 00 00 00 00 00 00 00 00 00 00 00 00 00 00 00 00 00 00 00 00 00 00 00 00 00 00 00 00 00 00 00 00 00 00 00 00 00 00 00 00 00 00 00 00 00 00 00 00 00 00 00 00 00 00 00 00 00 00 00 00 00 00 00 00 00 00 00 00 00 00 00 00 00 00 00 00 00 00 00 00 00 00 00 00 00 00 00 00
00 00 00 00 00 00 00 00 00 00 00 00 00 00 00 00 00 00 00 00 00 00 00 00 00 00 00 00 00 00 00 00 00 00 00 00 00 00 00 00 00 00 00 00 00 00 00 00 00 00 00 00 00 00 00 00 00 00 00 00 00 00 00 00 00 00 00 00 00 00 00 00 00 00 00 00 00 00 00 00 00 00 00 00 00 00 00 00 00 00 00 00 00 00 00 00 00 00 00 00 00 00 00 00 00 00 00 00 00 00 00 00 00 00 00 00 00 00 00 00 00 00 00 00 00 00 00 00 00 00 00 00 00 00 00 00 00 00 00 00 00 00 00 00 00 00 00 00 00 00 00 00 00 00 00 00 00 00 00 00
06 06 06 06 06 08 10 06 06 06 06 08 09 10 06 06 17 06 06 08 10 06 08 10 06 17 17 06 06 06 06 08 10 06 06 08 09 10 17 06 06 06 06 06 06 06 06 06 17 08 09 09 10 06 17 17 17 06 08 09 09 10 06 06 17 17 06 06 06 06 17 06 06 06 17 17 17 06 06 08 10 17 08 10 06 08 10 06 08 09 10 17 17 06 06 06 08 09 10 17 08 09 10 06 06 06 06 06 08 10 06 06 06 17 17 17 08 09 10 06 06 17 17 17 17 06 06 17 08 10 06 06 06 06 06 08 09 09 10 17 06 06 06 06 06 06 08 09 09 09 09 10 06 17 06 06 06 06 06 06
07 07 07 07 07 11 13 07 07 07 07 11 12 13 07 07 07 07 07 11 13 07 11 13 07 07 07 07 07 07 07 11 13 07 07 11 12 13 07 07 07 07 07 07 07 07 07 07 07 11 12 12 13 07 07 07 07 07 11 12 12 13 07 07 07 07 07 07 07 07 07 07 07 07 07 07 07 07 07 11 13 07 11 13 07 11 13 07 11 12 13 07 07 07 07 07 11 12 13 07 11 12 13 07 07 07 07 07 11 13 07 07 07 07 07 07 11 12 13 07 07 07 07 07 07 07 07 07 11 13 07 07 07 07 07 11 12 12 13 07 07 07 07 07 07 07 11 12 12 12 12 13 07 07 07 07 07 07 07 07
99 99 99 99 99 14 16 99 99 99 99 14 15 16 99 99 99 99 99 14 16 99 14 16 99 99 99 99 99 99 99 14 16 99 99 14 15 16 99 99 99 99 99 99 99 99 99 99 99 14 15 15 16 99 99 99 99 99 14 15 15 16 99 99 99 99 99 99 99 99 99 99 99 99 99 99 99 99 99 14 16 99 14 16 99 14 16 99 14 15 16 99 99 99 99 99 14 15 16 99 14 15 16 99 99 99 99 99 14 16 99 99 99 99 99 99 14 15 16 99 99 99 99 99 99 99 99 99 14 16 99 99 99 99 99 14 15 15 16 99 99 99 99 99 99 99 14 15 15 15 15 16 99 99 99 99 99 99 99 99