41 00 00 00 00 00 00 00 00 00 00 00 00 00 00 00 00 00 00 00 00 00 00 00 00 00 00 00 00 00 00 00 42 00 00 00 00 00 00 00 00 00 00 00 00 00 00 00 00 00 00 00 00 00 00 00 00 00 00 00 00 00 00 00 43 00 00 00 00 00 00 00 00 00 00 00 00 00 00 00 00 00 00 00 00 00 00 00 00 00 00 00 00 00 00 00 44 00 00 00 00 00 00 00 00 00 00 00 00 00 00 00 00 00 00 00 00 00 00 00 00 00 00 00 00 00 00 00 45 00 00 00 00 00 00 00 00 00 00 00 00 00 00 00 00 00 00 00 00 00 00 00 00 00 00 00 00 00 00 00
00 00 00 00 00 00 00 00 00 00 00 00 00 00 00 00 00 00 00 00 00 00 00 00 00 00 00 00 00 00 00 00 00 00 00 00 00 00 00 00 00 00 00 00 00 00 00 00 00 00 00 00 00 00 00 00 00 00 00 00 00 00 00 00 00 00 00 00 00 00 00 00 00 00 00 00 00 00 00 00 00 00 00 00 00 00 00 00 00 00 00 00 00 00 00 00 00 00 00 00 00 00 00 00 00 00 00 00 00 00 00 00 00 00 00 00 00 00 00 00 00 00 00 00 00 00 00 00 00 00 00 00 00 00 00 00 00 00 00 00 00 00 00 00 00 00 00 00 00 00 00 00 00 00 00 00 00 00 00 00
00 00 00 00 00 00 00 00 00 00 00 00 00 00 00 00 00 00 00 00 00 00 00 00 00 00 00 00 00 00 00 00 00 00 00 00 00 00 00 00 00 00 00 00 00 00 00 00 00 00 00 00 00 00 00 00 00 00 00 00 00 00 00 00 00 00 00 00 00 00 00 00 00 00 00 00 00 00 00 00 00 00 00 00 00 00 00 00 00 00 00 00 00 00 00 00 00 00 00 00 00 00 00 00 00 00 00 00 00 00 00 00 00 00 00 00 00 00 00 00 00 00 00 00 00 00 00 00 00 00 00 00 00 00 00 00 00 00 00 00 00 00 00 00 00 00 00 00 00 00 00 00 00 00 00 00 00 00 00 00
00 00 00 00 00 00 00 00 00 00 00 00 00 00 00 00 00 00 00 00 00 00 00 00 00 00 00 00 00 00 00 00 00 00 00 00 00 00 00 00 00 00 00 00 00 00 00 00 00 00 00 00 00 00 00 00 00 00 00 00 00 00 00 00 00 00 00 00 00 00 00 00 00 00 00 00 00 00 00 00 00 00 00 00 00 00 00 00 00 00 00 00 00 00 00 00 00 00 00 00 00 00 00 00 00 00 00 00 00 00 00 00 00 00 00 00 00 00 00 00 00 00 00 00 00 00 00 00 00 00 00 00 00 00 00 00 00 00 00 00 00 00 00 00 00 00 00 00 00 00 00 00 00 00 00 00 00 00 00 00
00 00 00 00 00 00 00 46 00 47 00 00 00 00 00 00 00 00 00 00 00 46 00 47 00 00 00 00 00 00 00 00 00 00 00 46 00 47 00 00 00 00 00 00 00 00 00 00 00 46 00 47 00 00 00 00 00 00 00 00 00 00 00 46 00 47 00 00 00 00 00 00 00 00 00 00 00 46 00 47 00 00 00 00 00 00 00 00 00 00 00 46 00 47 00 00 00 00 00 00 00 00 00 00 00 46 00 47 00 00 00 00 00 00 00 00 00 00 00 46 00 47 00 00 00 00 00 00 00 00 00 00 00 46 00 47 00 00 00 00 00 00 00 00 00 00 00 46 00 47 00 00 00 00 00 00 00 00 00 00
00 00 00 00 00 57 58 48 49 50 55 56 00 00 00 00 00 00 00 57 58 48 49 50 55 56 00 00 00 00 00 00 00 57 58 48 49 50 55 56 00 00 00 00 00 00 00 57 58 48 49 50 55 56 00 00 00 00 00 00 00 57 58 48 49 50 55 56 00 00 00 00 00 00 00 57 58 48 49 50 55 56 00 00 00 00 00 00 00 57 58 48 49 50 55 56 00 00 00 00 00 00 00 57 58 48 49 50 55 56 00 00 00 00 00 00 00 57 58 48 49 50 55 56 00 00 00 00 00 00 00 57 58 48 49 50 55 56 00 00 00 00 00 00 00 57 58 48 49 50 55 56 00 00 00 00 00 00 00 57
56 00 57 58 53 00 00 51 00 52 00 00 53 55 56 00 57 58 53 00 00 51 00 52 00 00 53 55 56 00 57 58 53 00 00 51 00 52 00 00 53 55 56 00 57 58 53 00 00 51 00 52 00 00 53 55 56 00 57 58 53 00 00 51 00 52 00 00 53 55 56 00 57 58 53 00 00 51 00 52 00 00 53 55 56 00 57 58 53 00 00 51 00 52 00 00 53 55 56 00 57 58 53 00 00 51 00 52 00 00 53 55 56 00 57 58 53 00 00 51 00 52 00 00 53 55 56 00 57 58 53 00 00 51 00 52 00 00 53 55 56 00 57 58 53 00 00 51 00 52 00 00 53 55 56 00 57 58 53 00
00 53 00 00 54 00 00 48 49 50 00 00 54 00 00 53 00 00 54 00 00 48 49 50 00 00 54 00 00 53 00 00 54 00 00 48 49 50 00 00 54 00 00 53 00 00 54 00 00 48 49 50 00 00 54 00 00 53 00 00 54 00 00 48 49 50 00 00 54 00 00 53 00 00 54 00 00 48 49 50 00 00 54 00 00 53 00 00 54 00 00 48 49 50 00 00 54 00 00 53 00 00 54 00 00 48 49 50 00 00 54 00 00 53 00 00 54 00 00 48 49 50 00 00 54 00 00 53 00 00 54 00 00 48 49 50 00 00 54 00 00 53 00 00 54 00 00 48 49 50 00 00 54 00 00 53 00 00 54 00
00 54 00 00 54 00 00 51 00 52 00 00 54 00 00 54 00 00 54 00 00 51 00 52 00 00 54 00 00 54 00 00 54 00 00 51 00 52 00 00 54 00 00 54 00 00 54 00 00 51 00 52 00 00 54 00 00 54 00 00 54 00 00 51 00 52 00 00 54 00 00 54 00 00 54 00 00 51 00 52 00 00 54 00 00 54 00 00 54 00 00 51 00 52 00 00 54 00 00 54 00 00 54 00 00 51 00 52 00 00 54 00 00 54 00 00 54 00 00 51 00 52 00 00 54 00 00 54 00 00 54 00 00 51 00 52 00 00 54 00 00 54 00 00 54 00 00 51 00 52 00 00 54 00 00 54 00 00 54 00